0000000000000000000000000000000000000000000000000000000000000000000000000000000000000000000000000000
0111111111100000000000000000000000000000000000000000000000000000000000000000000000000000000000000000
0100000000100000000000000000000000000000000000000000000000000000000000000000000000000000000000000000
0100000000111111100000000000000000000000000000000000000000000000000000000000000000000000000000000000
0111111000001000100000000000000000000000000000000000000000000000000000000000000000000000000000000000
0100001000001000100000000000000000000000000000000000000000000000000000000000000000000000000000000000
0100001111111000111111111111111110000000000000000000000000000000000000000000000000000000000000000000
0100001000001000100000000000000010000000000000000000000000000000000000000000000000000000000000000000
0100001000001000100000000000000010000000000000000000000000000000000000000000000000000000000000000000
0111111111001000100000000000000010000000000000000000000000000000000000000000000000000000000000000000
0100000001001000100000000000000010000000000000000000000000000000000000000000000000000000000000000000
0100000001111111111111111110000011111111111111111100000000000000000000000000000000000000000000000000
0100000001000000000001000010000010000001000001000111111111111111111100000000000000000000000000000000
0111111111000000000001000010000010000001000001000100000010000000000100000000000000000000000000000000
0100000001000000000001000010000010000001000001000100000010000000000100000000000000000000000000000000
0100000001000000000001000011111110000001111111111100000010000000000100000000000000000000000000000000
0100000001000000000001111010000000000001000000000100000010000000000100000000000000000000000000000000
0100000001000000000001001110000000000001000000000100000010000000000100000000000000000000000000000000
0111111111111111111111000010000000000001000000000100000011111111111100000000000000000000000000000000
0100001000010000100000000010000000000001000000000100000010000000000100000000000000000000000000000000
0100001000010000100000000011111111111111111110000100000010000000000100000000000000000000000000000000
0100001000010000111111111110000100001000000010000100000010000000000100000000000000000000000000000000
0100001000010000100000100000000100001000000010000100000010000001111111110000000000000000000000000000
0100001000010000100000100000000100001000000010000100000010000001000000010000000000000000000000000000
0100001000010000100000100000000100001000000010000100000010000001000000010000000000000000000000000000
0100001000010000100000100000000100001000000011111111111111100001000011111111111000000000000000000000
0111111111111111100000111111111100001000000010000000001000100001000010000000001000000000000000000000
0001000000000010000000100000000100001000000010000000001000111111000010000000001000000000000000000000
0001000000000010000000100000000100001000000010000000001000100001000010000000001111111111111111100000
0001000000000010000000100000000100001000000010000000001000100001000010000000001000000000000000100000
0111111111111111111111111111111100001000000010000000001000100001111111100000001000000000000000100000
0100000000100000000001000000000111111111111110000000111111100001000000100000001000000000000000100000
0100000000100000000001000000000100000000100000000000100000100001000000100000001000000000000000100000
0100000000100000000001000000000100000000100000000000100000100001000000111111111111111111100000100000
0111111111100000000001000000000100000000100000000000100000111111000000100000000000010000100000100000
0100000000100000000001000000000100000000100000000000100000100001000000100000000000010000100000100000
0100000000111111111111111111111100000000111111000000100000100001000000100000000000010000111111100000
0100000000100000100000001000000100000000100001111111100000100001000000100000000000010000100000000000
0100000000100000100000001000000100000000100001000000000000100001000000100000000000010000100000000000
0100000000100000100000001000000100000000100001000000000000100001111111111111111111110000100000000000
0100000000100000100000001000000100000000111111111111111111100001000010000100001000000000100000000000
0111111111111111111111111111111100000000000000000100000010000001000010000100001000000000100001111100
0000000000000000000000000000000000000000000000000100000010000001000010000100001000000000111111000100
0000000000000000000000000000000000000000000000000100000010000001000010000100001111111111100001000100
0000000000000000000000000000000000000000000000000111111111111111000010000100001000000000000001000100
0000000000000000000000000000000000000000000000000100001000001001000010000100001000000000000001000100
0000000000000000000000000000000000000000000000000100001000001001000010000100001000000000000001000100
0000000000000000000000000000000000000000000000000100001000001001000010000100001000000000000001111100
0000000000000000000000000000000000000000000000000100001000001001111111111111111000000000000001000100
0000000000000000000000000000000000000000000000000100001000001000010000000001000000000000000001000100
0000000000000000000000000000000000000000000000000100001000001000010000000001000000000000000001000100
0000000000000000000000000000000000000000000000000100001111111111111111111111111111111111111111000100
0000000000000000000000000000000000000000000000000100001000000001000000001000001000010000000001000100
0000000000000000000000000000000000000000000000000100001000000001000000001000001000010000000001111100
0000000000000000000000000000000000000000000000000100001000000001111111111000001111110000000001000000
0000000000000000000000000000000000000000000000000100001000000001000010001000000000010000000001000000
0000000000000000000000000000000000000000000000000100001000000001000010001000000000010000000001000000
0000000000000000000000000000000000000000000000000111111111111111000010001000000000010000000001000000
0000000000000000000000000000000000000000000000000000000000000001000010001111111111111111110001000000
0000000000000000000000000000000000000000000000000000000000000001000010001000001000000000010001000000
0000000000000000000000000000000000000000000000000000000000000001000010001000001000000000010001000000
0000000000000000000000000000000000000000000000000000000000000001000010001000001000000000010001000000
0000000000000000000000000000000000000000000000000000000000000001000010001000001000000000010001000000
0000000000000000000000000000000000000000000000000000000000000001111111111111111111111111111111000000
0000000000000000000000000000000000000000000000000000000000000000000000000000000000000000000000000000
0000000000000000000000000000000000000000000000000000000000000000000000000000000000000000000000000000
0000000000000000000000000000000000000000000000000000000000000000000000000000000000000000000000000000
0000000000000000000000000000000000000000000000000000000000000000000000000000000000000000000000000000
0000000000000000000000000000000000000000000000000000000000000000000000000000000000000000000000000000
0000000000000000000000000000000000000000000000000000000000000000000000000000000000000000000000000000
0000000000000000000000000000000000000000000000000000000000000000000000000000000000000000000000000000
0000000000000000000000000000000000000000000000000000000000000000000000000000000000000000000000000000
0000000000000000000000000000000000000000000000000000000000000000000000000000000000000000000000000000
0000000000000000000000000000000000000000000000000000000000000000000000000000000000000000000000000000
0000000000000000000000000000000000000000000000000000000000000000000000000000000000000000000000000000
0000000000000000000000000000000000000000000000000000000000000000000000000000000000000000000000000000
0000000000000000000000000000000000000000000000000000000000000000000000000000000000000000000000000000
0000000000000000000000000000000000000000000000000000000000000000000000000000000000000000000000000000
0000000000000000000000000000000000000000000000000000000000000000000000000000000000000000000000000000
0000000000000000000000000000000000000000000000000000000000000000000000000000000000000000000000000000
0000000000000000000000000000000000000000000000000000000000000000000000000000000000000000000000000000
0000000000000000000000000000000000000000000000000000000000000000000000000000000000000000000000000000
0000000000000000000000000000000000000000000000000000000000000000000000000000000000000000000000000000
0000000000000000000000000000000000000000000000000000000000000000000000000000000000000000000000000000
0000000000000000000000000000000000000000000000000000000000000000000000000000000000000000000000000000
0000000000000000000000000000000000000000000000000000000000000000000000000000000000000000000000000000
0000000000000000000000000000000000000000000000000000000000000000000000000000000000000000000000000000
0000000000000000000000000000000000000000000000000000000000000000000000000000000000000000000000000000
0000000000000000000000000000000000000000000000000000000000000000000000000000000000000000000000000000
0000000000000000000000000000000000000000000000000000000000000000000000000000000000000000000000000000
0000000000000000000000000000000000000000000000000000000000000000000000000000000000000000000000000000
0000000000000000000000000000000000000000000000000000000000000000000000000000000000000000000000000000
0000000000000000000000000000000000000000000000000000000000000000000000000000000000000000000000000000
0000000000000000000000000000000000000000000000000000000000000000000000000000000000000000000000000000
0000000000000000000000000000000000000000000000000000000000000000000000000000000000000000000000000000
0000000000000000000000000000000000000000000000000000000000000000000000000000000000000000000000000000
0000000000000000000000000000000000000000000000000000000000000000000000000000000000000000000000000000
0000000000000000000000000000000000000000000000000000000000000000000000000000000000000000000000000000
0000000000000000000000000000000000000000000000000000000000000000000000000000000000000000000000000000
0000000000000000000000000000000000000000000000000000000000000000000000000000000000000000000000000000
