0000000000000000000000000000000000000000000000000000000000000000000000000000000000000000000000000000
0111111111100000000000000000000000000000000000000000000000000000000000000000000000000000000000000000
0100000000100000000000000000000000000000000000000000000000000000000000000000000000000000000000000000
0100000000111111100000000000000000000000000000000000000000000000000000000000000000000000000000000000
0100001000000000100000000000000000000000000000000000000000000000000000000000000000000000000000000000
0100001000000000100000000000000000000000000000000000000000000000000000000000000000000000000000000000
0100001000000000111111111111111110000000000000000000000000000000000000000000000000000000000000000000
0100001000000000100000000000000010000000000000000000000000000000000000000000000000000000000000000000
0100001000000000100000000000000010000000000000000000000000000000000000000000000000000000000000000000
0111111111000000100000000000000010000000000000000000000000000000000000000000000000000000000000000000
0100000001000000100000000000000010000000000000000000000000000000000000000000000000000000000000000000
0100000001111111111111111110000011111111111111111100000000000000000000000000000000000000000000000000
0100000001000000000001000010000010000000000000000111111111111111111100000000000000000000000000000000
0100000001000000000001000010000010000000000000000100000000000000000100000000000000000000000000000000
0100000001000000000001000010000010000000000000000100000000000000000100000000000000000000000000000000
0100000001000000000001000011111110000000000000000100000000000000000100000000000000000000000000000000
0100000001000000000001000010000000000000000000000100000000000000000100000000000000000000000000000000
0100000001000000000001000010000000000000000000000100000000000000000100000000000000000000000000000000
0111111111111111111111000010000000000000000000000100000000000000000100000000000000000000000000000000
0100001000010000100000000010000000000000000000000100000000000000000100000000000000000000000000000000
0100001000010000100000000010000111111111111110000100000000000000000100000000000000000000000000000000
0100001000010000111111111110000100000000000010000100000000000000000100000000000000000000000000000000
0100001000010000100000000000000100000000000010000100000000000001111111110000000000000000000000000000
0100001000010000100000000000000100000000000010000100000000000001000000010000000000000000000000000000
0100001000010000100000000000000100000000000010000100000000000001000000010000000000000000000000000000
0100001000010000100000000000000100000000000011111111111111100001000011111111111000000000000000000000
0111111111111111100000000000000100000000000010000000000000100001000010000000001000000000000000000000
0001000000000010000000000000000100000000000010000000000000100001000010000000001000000000000000000000
0001000000000010000000000000000100000000000010000000000000100001000010000000001111111111111111100000
0001000000000010000000000000000100000000000010000000000000100001000010000000001000000000000000100000
0111111111111111111111111111111100000000000010000000000000100001111111100000001000000000000000100000
0100000000100000000001000000000111111111111110000000000000100001000000100000001000000000000000100000
0100000000100000000001000000000100000000100000000000000000100001000000100000001000000000000000100000
0100000000100000000001000000000100000000100000000000000000100001000000111111111111111111100000100000
0100000000100000000001000000000100000000100000000000000000111111000000100000000000010000100000100000
0100000000100000000001000000000100000000100000000000000000100001000000100000000000010000100000100000
0100000000111111111111111111100100000000100000000000000000100001000000100000000000010000111111100000
0100000000100000000000000000000100000000100000000000000000100001000000100000000000010000100000000000
0100000000100000000000000000000100000000100000000000000000100001000000100000000000010000100000000000
0100000000100000000000000000000100000000100000000000000000100001111111111111111111110000100000000000
0100000000100000000000000000000100000000111111111111111111100001000010000100001000000000100000000000
0111111111111111111111111111111100000000000000000100000000000001000010000100001000000000100001111100
0000000000000000000000000000000000000000000000000100000000000001000010000100001000000000100001000100
0000000000000000000000000000000000000000000000000100000000000001000010000100001111111111100001000100
0000000000000000000000000000000000000000000000000100000000000001000010000100001000000000000001000100
0000000000000000000000000000000000000000000000000100000000000001000010000100001000000000000001000100
0000000000000000000000000000000000000000000000000100000000000001000010000100001000000000000001000100
0000000000000000000000000000000000000000000000000100000000000001000010000100001000000000000001000100
0000000000000000000000000000000000000000000000000100000000000001111111111111111000000000000001000100
0000000000000000000000000000000000000000000000000100000000000000010000000001000000000000000001000100
0000000000000000000000000000000000000000000000000100000000000000010000000001000000000000000001000100
0000000000000000000000000000000000000000000000000100000000000001111111111111111111111111111111000100
0000000000000000000000000000000000000000000000000100000000000001000000001000000000010000000001000100
0000000000000000000000000000000000000000000000000100000000000001000000001000000000010000000001111100
0000000000000000000000000000000000000000000000000100000000000001000000001000000000010000000001000000
0000000000000000000000000000000000000000000000000100000000000001000000001000000000010000000001000000
0000000000000000000000000000000000000000000000000100000000000001000000001000000000010000000001000000
0000000000000000000000000000000000000000000000000111111111111111000000001000000000010000000001000000
0000000000000000000000000000000000000000000000000000000000000001000000001111111111111111110001000000
0000000000000000000000000000000000000000000000000000000000000001000000001000000000000000000001000000
0000000000000000000000000000000000000000000000000000000000000001000000001000000000000000000001000000
0000000000000000000000000000000000000000000000000000000000000001000000001000000000000000000001000000
0000000000000000000000000000000000000000000000000000000000000001000000001000000000000000000001000000
0000000000000000000000000000000000000000000000000000000000000001111111111111111111111111111111000000
0000000000000000000000000000000000000000000000000000000000000000000000000000000000000000000000000000
0000000000000000000000000000000000000000000000000000000000000000000000000000000000000000000000000000
0000000000000000000000000000000000000000000000000000000000000000000000000000000000000000000000000000
0000000000000000000000000000000000000000000000000000000000000000000000000000000000000000000000000000
0000000000000000000000000000000000000000000000000000000000000000000000000000000000000000000000000000
0000000000000000000000000000000000000000000000000000000000000000000000000000000000000000000000000000
0000000000000000000000000000000000000000000000000000000000000000000000000000000000000000000000000000
0000000000000000000000000000000000000000000000000000000000000000000000000000000000000000000000000000
0000000000000000000000000000000000000000000000000000000000000000000000000000000000000000000000000000
0000000000000000000000000000000000000000000000000000000000000000000000000000000000000000000000000000
0000000000000000000000000000000000000000000000000000000000000000000000000000000000000000000000000000
0000000000000000000000000000000000000000000000000000000000000000000000000000000000000000000000000000
0000000000000000000000000000000000000000000000000000000000000000000000000000000000000000000000000000
0000000000000000000000000000000000000000000000000000000000000000000000000000000000000000000000000000
0000000000000000000000000000000000000000000000000000000000000000000000000000000000000000000000000000
0000000000000000000000000000000000000000000000000000000000000000000000000000000000000000000000000000
0000000000000000000000000000000000000000000000000000000000000000000000000000000000000000000000000000
0000000000000000000000000000000000000000000000000000000000000000000000000000000000000000000000000000
0000000000000000000000000000000000000000000000000000000000000000000000000000000000000000000000000000
0000000000000000000000000000000000000000000000000000000000000000000000000000000000000000000000000000
0000000000000000000000000000000000000000000000000000000000000000000000000000000000000000000000000000
0000000000000000000000000000000000000000000000000000000000000000000000000000000000000000000000000000
0000000000000000000000000000000000000000000000000000000000000000000000000000000000000000000000000000
0000000000000000000000000000000000000000000000000000000000000000000000000000000000000000000000000000
0000000000000000000000000000000000000000000000000000000000000000000000000000000000000000000000000000
0000000000000000000000000000000000000000000000000000000000000000000000000000000000000000000000000000
0000000000000000000000000000000000000000000000000000000000000000000000000000000000000000000000000000
0000000000000000000000000000000000000000000000000000000000000000000000000000000000000000000000000000
0000000000000000000000000000000000000000000000000000000000000000000000000000000000000000000000000000
0000000000000000000000000000000000000000000000000000000000000000000000000000000000000000000000000000
0000000000000000000000000000000000000000000000000000000000000000000000000000000000000000000000000000
0000000000000000000000000000000000000000000000000000000000000000000000000000000000000000000000000000
0000000000000000000000000000000000000000000000000000000000000000000000000000000000000000000000000000
0000000000000000000000000000000000000000000000000000000000000000000000000000000000000000000000000000
0000000000000000000000000000000000000000000000000000000000000000000000000000000000000000000000000000
0000000000000000000000000000000000000000000000000000000000000000000000000000000000000000000000000000
